1111111111111
1111100000001
10P1101111101
1011100110001
1000001110111
1011100010001
11101011110C1
1E000001C0001
1111111111111
